11111111111111111111
1      2           1
1   33 3 11  22   1
1      3           1
1      3    2     11
1      32222       1
1          2      11
1  2       2     111
1  11111           1
11111111111111111111